##############################
#...#..........#.............#
#.#.#.########.#.###########.#
#.#.#.####...#.#...#########.#
#..........###.###...........#
####.#######.....###.#######.#
#........#...#.#...#....#....#
#.#.##.#.#.#######.#.##.#..#.#
#........#.#.....#.#.##.####.#
#.#.##.#...#.....#...##......#
#........#.#.....#.###########
#.#.##.#.#.#######.###...#...#
#........#.............#...#.#
#.#.##.#.#####.#############.#
#........#...................#
#.#.##.#.#.####.######.#######
#........#.#....#...##.......#
#.######.#.#.####.#.########.#
#..........#......#..........#
##############################