###############################
#.............................#
#.######.#############.######.#
#.#....#.#....................#
#.#.##.#.#.#.##############.#.#
#.#.##.#.#.#..................#
#.#.##.#.#.#.#.######.######..#
#.#....#.#....................#
#.######.#.#.#.######.#######.#
#........#.#.#.#....#.#.....#.#
#.########.#.#.#.##.....###.#.#
#..........#.#.#.##########.#.#
#.########.#.#.#............#.#
#............#.#.##########.#.#
#..#########...#.#.#.##.#.#...#
##...........#.#.#.#....#.#.#.#
#..#########.#.#.#........#.#.#
#.#....#...#.#...##########.#.#
#....#...#...#.#..............#
###############################
