########################################
#.................................#....#
#.#.####.#############.##########.#.##.#
#.#....#.#........................#..#.#
#.#.##.#.#.#.##############.#####.####.#
#.#.##.#.#.#....................#......#
#.#.##.#.#.#.#.######.#########.####.###
#.#....#.#.#..................#.#..#.#.#
#.######.#.#.#.######.#######.#.#..#.#.#
#........#.#.#.#....#.#.....#.#.#......#
#.########.#.#.#.##.....###.#.#.#.######
#..........#.#.#.##########.#.#.#......#
#.########.#.#.#............#.#.######.#
#............#.#.##########.#.#........#
#..#########...#.#.#.##.#.#.#...#.####.#
##...........#.#.#.#....#.#.#.#.#..##..#
#..#########.#.#.#.#....#.#.#.#.#..##..#
#.##...#...#.#.#.##########.#.#.#.####.#
#....#...#...#..................#......#
########################################
