#########################
#.......................#
#.######.#############.##
#.#....#.#..............#
#.#.##.#.#.#.############
#.#.##.#.#.#............#
#.#.##.#.#.#.#.######.###
#.#....#.#..............#
#.######.#.#.#.######.###
#........#.#.#.#....#.#.#
#.########.#.#.#.##.....#
#..........#.#.#.########
#.########.#.#.#........#
#............#.#.########
#########################


