#########################
#........#..........#...#
#.######.#.#.######.#...#
#.#....#.#.#......#.#...#
#.#.##.#...#.####.#.#####
#...##...#.#.####.......#
#.#.##.#..........#####.#
#.#....#.######.#...#...#
#.######.#...##.###.#.#.#
#........#.#.##.#.#.#.#.#
#.########.#.##.#.#.#.#.#
#..........#....#.#.#.#.#
#.#############...#.#.#.#
#...............#.......#
#########################


