########################################
#.................................#....#
#.######.#############.##########.#.##.#
#.#....#.#........................#..#.#
#.#.##.#.#.#.##############.#####.####.#
#.#.##.#.#.#....................#......#
#.#.##.#.#.#.#.######.#########.####.###
#.#....#.#.#..................#.#..#.#.#
#.######.#.#.#.######.#######.#.#..#.#.#
#........#.#.#.#....#.#.....#.#.#......#
#.########.#.#.#.##.....###.#.#.##.#####
#..........#.#.#.##########.#.#.#......#
#.########.#.#.#............#.#.######.#
#............#.#.##########.#.#........#
#..#########...#.#.#.##.#.#.#...#.####.#
##...........#.#.#.#....#.#.#.#.#..##..#
#..#########.#.#.#........#.#.#.#..##..#
#.##...#...#.#...##########.#.#.#.####.#
#....#...#...#.#................#......#
########################################
