#########################
#........#..........#...#
#.######.#.#.######.#...#
#.#....#.#.#......#.#...#
#.#.##.#...#.####.#.#####
#...##...#.#.####.......#
#.#.##.#..........#####.#
#.#....#.######.#...#...#
#.######.#...##.###.#.#.#
#........#.#.##.#.#.#.#.#
#.########.#.####.#.#.#.#
#..........#....#.#.#.#.#
#.#############.#.#.#.#.#
#.............#.....#...#
#########################


